14
24
1 1 1 1 1 1 1 1 1 1 1 1 1 1 1 1 1 1 1 1 1 1 1 1
1 3 0 0 7 0 0 0 0 0 0 0 3 -2 -2 -2 3 -1 3 0 3 7 3 1
1 7 3 3 7 0 0 0 0 0 0 0 7 -3 -3 -3 3 -1 3 0 0 0 3 1
1 0 0 0 4 0 0 0 0 0 4 3 3 3 3 3 4 7 3 0 3 0 3 1
1 0 0 0 4 3 0 3 3 3 4 0 0 0 0 0 0 0 3 0 3 0 3 1
1 0 0 0 7 7 0 0 0 0 3 0 3 3 3 3 4 0 3 0 3 0 3 1
1 0 0 0 7 7 0 3 3 0 0 0 7 0 0 0 3 0 7 7 3 0 3 1
1 0 0 0 7 7 7 7 7 0 3 0 3 4 4 3 3 3 4 4 3 0 3 1
1 0 0 0 7 0 0 0 0 0 0 0 0 0 0 0 0 0 0 0 0 0 4 1
1 0 0 0 4 4 0 4 3 3 3 3 3 3 3 3 3 3 3 3 3 3 3 1
1 0 0 0 4 0 0 0 0 0 0 0 0 0 0 0 0 0 0 0 0 0 0 1
1 7 3 3 7 3 3 3 3 3 3 3 3 3 3 3 3 3 3 3 4 0 4 1
1 1 0 0 0 0 -3 -3 7 0 0 0 -1 -1 -2 -2 0 0 0 0 0 0 3 1
1 1 1 1 1 1 1 1 1 1 1 1 1 1 1 1 1 1 1 1 1 1 1 1