14
24
12 17 17 17 17 17 17 17 17 17 17 17 17 17 17 17 17 17 17 17 17 17 17 10
14 0 22 0 0 0 0 20 0 21 0 0 0 0 0 23 24 21 0 0 0 0 0 15
14 0 22 0 0 0 0 21 0 21 0 3 3 3 0 23 24 21 20 20 20 20 0 15
14 23 22 0 0 0 0 21 0 21 0 0 0 0 0 23 24 21 0 0 0 0 0 15
14 0 22 0 0 0 0 21 0 21 20 3 3 3 0 23 24 21 20 21 21 21 21 15 
14 0 22 21 21 21 21 21 20 21 21 21 21 21 20 23 24 0 24 24 24 24 24 15
14 0 23 0 20 0 20 0 20 0 0 0 0 0 20 0 0 23 23 23 23 23 23 15
14 0 23 20 0 20 0 0 20 0 0 0 20 20 0 0 22 23 23 0 0 0 0 15
14 0 22 21 21 20 21 21 20 20 0 20 20 0 0 22 21 21 21 21 21 21 0 15
14 0 22 0 0 0 0 21 20 0 0 20 0 0 22 0 0 0 0 0 0 0 0 15
14 23 22 0 0 0 0 21 20 21 21 20 20 22 0 21 21 21 0 21 21 21 21 15
14 0 22 0 0 0 0 21 20 20 0 20 20 22 0 21 0 0 0 0 0 21 0 15
14 0 22 0 0 0 0 21 20 20 0 0 20 22 0 0 0 21 0 21 0 0 0 15
13 16 16 16 16 16 16 16 16 16 16 16 16 16 16 16 16 16 16 16 16 16 16 11